F 255,255,255
C 20,20,20

NO textures/north.xpm
SO textures/south.xpm
EA textures/east.xpm
WE textures/west.xpm

11111111111
10000000001
10100000001
10000000001
10000000001
10000000001
10000100001
10000000001
10000000001111111111111111111111111
10000000000000000000000000000000001
10000000000000000000000000000000001
10000000000000000000000000000000001
10000000000000000000000000000000001
10000000000000000011111000000000001
10000000000000000000000000000000001
10000000000000000000000000000000001
10000000000000000000000000000000001
10000000000000000000000000000000001
10000000001111111111111111111111111
10001000001
10000000001 
10000000001
10000000001
10000W00001
10000100001
10000001001
11111111111
