F 189,49,0
C 39,199,212
NO textures/north.xpm
SO textures/south.xpm
EA textures/east.xpm
WE textures/west.xpm

11111111111
11001111111
110000000011111
11001100000011111
100000001110011
10000S01   10001
100000010   1001
 10000001111001
100000000000011
1000000000111
11111111111
